Year,RK,Team,GP,OFF,ORPG,DEF,DRPG,REB,RPG
2021,1,North Carolina,28,445,15.9,764,27.3,1209,43.2
2021,2,Texas Southern,24,298,12.4,700,29.2,998,41.6
2021,3,Houston,27,387,14.3,723,26.8,1110,41.1
2021,4,Utah State,28,353,12.6,789,28.2,1142,40.8
2021,5,Alabama,30,372,12.4,843,28.1,1215,40.5
2021,6,Illinois,29,313,10.8,859,29.6,1172,40.4
2021,7,Winthrop,24,313,13,653,27.2,966,40.3
2021,8,Georgetown,25,292,11.7,713,28.5,1005,40.2
2021,9,Iowa,29,327,11.3,837,28.9,1164,40.1
2021,10,Grand Canyon,23,248,10.8,673,29.3,921,40
2021,11,Arkansas,28,335,12,784,28,1119,40
2021,12,Colgate,15,146,9.7,450,30,596,39.7
2021,13,USC,29,356,12.3,789,27.2,1145,39.5
2021,14,BYU,26,247,9.5,777,29.9,1024,39.4
2021,15,UNC Greensboro,29,377,13,765,26.4,1142,39.4
2021,16,Texas,26,286,11,719,27.7,1005,38.7
2021,17,Oklahoma State,28,310,11.1,771,27.5,1081,38.6
2021,18,LSU,27,310,11.5,724,26.8,1034,38.3
2021,19,West Virginia,27,365,13.5,665,24.6,1030,38.1
2021,20,UConn,22,291,13.2,548,24.9,839,38.1
2021,21,Wichita State,21,252,12,547,26,799,38
2021,22,Kansas,28,319,11.4,745,26.6,1064,38
2021,23,Gonzaga,26,249,9.6,737,28.3,986,37.9
2021,24,Michigan State,27,294,10.9,721,26.7,1015,37.6
2021,25,Purdue,27,294,10.9,721,26.7,1015,37.6
2021,26,Morehead State,30,309,10.3,816,27.2,1125,37.5
2021,27,Iona,17,189,11.1,448,26.4,637,37.5
2021,28,Michigan,24,219,9.1,680,28.3,899,37.5
2021,29,Florida State,22,257,11.7,565,25.7,822,37.4
2021,30,Mount St. Mary's,22,239,10.9,582,26.5,821,37.3
2021,31,St. Bonaventure,20,229,11.5,516,25.8,745,37.3
2021,32,Norfolk State,23,241,10.5,609,26.5,850,37
2021,33,Baylor,24,309,12.9,566,23.6,875,36.5
2021,34,Abilene Christian,27,309,11.4,671,24.9,980,36.3
2021,35,Oklahoma,25,247,9.9,660,26.4,907,36.3
2021,36,Ohio State,30,292,9.7,794,26.5,1086,36.2
2021,37,Creighton,28,237,8.5,774,27.6,1011,36.1
2021,38,Drake,29,300,10.3,743,25.6,1043,36
2021,39,Appalachian State,28,308,11,699,25,1007,36
2021,40,Tennessee,26,282,10.8,653,25.1,935,36
2021,41,San Diego State,27,264,9.8,706,26.1,970,35.9
2021,42,Syracuse,25,274,11,622,24.9,896,35.8
2021,43,Missouri,25,248,9.9,644,25.8,892,35.7
2021,44,Eastern Washington,23,177,7.7,638,27.7,815,35.4
2021,45,Rutgers,26,254,9.8,664,25.5,918,35.3
2021,46,Oral Roberts,26,219,8.4,696,26.8,915,35.2
2021,47,UC Santa Barbara,26,245,9.4,670,25.8,915,35.2
2021,48,Florida,23,231,10,578,25.1,809,35.2
2021,49,Virginia Tech,21,198,9.4,540,25.7,738,35.1
2021,50,Texas Tech,27,317,11.7,631,23.4,948,35.1
2021,51,Colorado,30,296,9.9,754,25.1,1050,35
2021,52,UCLA,26,258,9.9,652,25.1,910,35
2021,53,Cleveland State,26,279,10.7,631,24.3,910,35
2021,54,Ohio,23,226,9.8,575,25,801,34.8
2021,55,Villanova,22,211,9.6,544,24.7,755,34.3
2021,56,VCU,26,242,9.3,648,24.9,890,34.2
2021,57,Drexel,19,168,8.8,477,25.1,645,33.9
2021,58,Oregon State,29,299,10.3,678,23.4,977,33.7
2021,59,Wisconsin,29,240,8.3,733,25.3,973,33.6
2021,60,Liberty,28,199,7.1,737,26.3,936,33.4
2021,61,North Texas,26,223,8.6,643,24.7,866,33.3
2021,62,Maryland,29,188,6.5,777,26.8,965,33.3
2021,63,Hartford,23,187,8.1,576,25,763,33.2
2021,64,Oregon,26,239,9.2,620,23.8,859,33
2021,65,Clemson,23,198,8.6,553,24,751,32.7
2021,66,Loyola Chicago,28,204,7.3,710,25.4,914,32.6
2021,67,Virginia,24,157,6.5,605,25.2,762,31.8
2021,68,Georgia Tech,25,204,8.2,566,22.6,770,30.8
2019,1,North Carolina,33,431,13.1,1006,30.5,1437,43.5
2019,2,Duke,34,455,13.4,965,28.4,1420,41.8
2019,3,Houston,33,408,12.4,950,28.8,1358,41.2
2019,4,Buffalo,34,431,12.7,966,28.4,1397,41.1
2019,5,Michigan State,33,357,10.8,996,30.2,1353,41
2019,6,UC Irvine,35,412,11.8,999,28.5,1411,40.3
2019,7,Utah State,34,368,10.8,1000,29.4,1368,40.2
2019,8,Arizona State,32,389,12.2,890,27.8,1279,40
2019,9,Saint Louis,34,469,13.8,883,26,1352,39.8
2019,10,Maryland,32,351,11,902,28.2,1253,39.2
2019,11,Old Dominion,34,408,12,916,26.9,1324,38.9
2019,12,Yale,28,245,8.8,845,30.2,1090,38.9
2019,13,Belmont,31,277,8.9,928,29.9,1205,38.9
2019,14,LSU,32,432,13.5,809,25.3,1241,38.8
2019,15,Gonzaga,33,315,9.5,960,29.1,1275,38.6
2019,16,Kentucky,33,383,11.6,885,26.8,1268,38.4
2019,17,New Mexico State,34,436,12.8,868,25.5,1304,38.4
2019,18,Louisville,33,339,10.3,923,28,1262,38.2
2019,19,Marquette,33,317,9.6,939,28.5,1256,38.1
2019,20,Kansas,34,353,10.4,941,27.7,1294,38.1
2019,21,Baylor,32,429,13.4,787,24.6,1216,38
2019,22,Murray State,31,336,10.8,839,27.1,1175,37.9
2019,23,Tennessee,33,344,10.4,900,27.3,1244,37.7
2019,24,Oklahoma,32,295,9.2,908,28.4,1203,37.6
2019,25,Florida State,34,389,11.4,882,25.9,1271,37.4
2019,26,North Carolina Central,33,389,11.8,844,25.6,1233,37.4
2019,27,Nevada,33,307,9.3,926,28.1,1233,37.4
2019,28,Northern Kentucky,34,361,10.6,898,26.4,1259,37
2019,29,Minnesota,34,389,11.4,870,25.6,1259,37
2019,30,Purdue,32,391,12.2,786,24.6,1177,36.8
2019,31,VCU,32,347,10.8,830,25.9,1177,36.8
2019,32,UCF,31,304,9.8,835,26.9,1139,36.7
2019,33,Cincinnati,33,424,12.8,769,23.3,1193,36.2
2019,34,Seton Hall,33,351,10.6,832,25.2,1183,35.8
2019,35,Mississippi State,33,385,11.7,796,24.1,1181,35.8
2019,36,Iowa,33,341,10.3,838,25.4,1179,35.7
2019,37,Colgate,34,323,9.5,886,26.1,1209,35.6
2019,38,Wofford,33,350,10.6,820,24.8,1170,35.5
2019,39,Villanova,34,357,10.5,847,24.9,1204,35.4
2019,40,Wisconsin,33,269,8.2,893,27.1,1162,35.2
2019,41,Vermont,33,307,9.3,854,25.9,1161,35.2
2019,42,Iowa State,34,320,9.4,876,25.8,1196,35.2
2019,43,Michigan,33,279,8.5,877,26.6,1156,35
2019,44,Syracuse,33,356,10.8,792,24,1148,34.8
2019,45,Ohio State,33,310,9.4,837,25.4,1147,34.8
2019,46,Saint Mary's,33,324,9.8,822,24.9,1146,34.7
2019,47,Virginia,32,284,8.9,824,25.8,1108,34.6
2019,48,Auburn,34,409,12,763,22.4,1172,34.5
2019,49,Oregon,35,340,9.7,865,24.7,1205,34.4
2019,50,Iona,32,283,8.8,818,25.6,1101,34.4
2019,51,Bradley,34,314,9.2,855,25.1,1169,34.4
2019,52,Gardner-Webb,34,269,7.9,900,26.5,1169,34.4
2019,53,Ole Miss,32,315,9.8,783,24.5,1098,34.3
2019,54,Temple,32,311,9.7,786,24.6,1097,34.3
2019,55,Texas Tech,32,283,8.8,814,25.4,1097,34.3
2019,56,Montana,34,293,8.6,853,25.1,1146,33.7
2019,57,Florida,34,361,10.6,777,22.9,1138,33.5
2019,58,Kansas State,33,312,9.5,786,23.8,1098,33.3
2019,59,Abilene Christian,33,325,9.8,768,23.3,1093,33.1
2019,60,Prairie View A&M,34,383,11.3,742,21.8,1125,33.1
2019,61,Fairleigh Dickinson,33,308,9.3,777,23.5,1085,32.9
2019,62,Liberty,34,265,7.8,849,25,1114,32.8
2019,63,Georgia State,32,263,8.2,784,24.5,1047,32.7
2019,64,Virginia Tech,32,285,8.9,758,23.7,1043,32.6
2019,65,St. John's,33,252,7.6,822,24.9,1074,32.5
2019,66,Northeastern,33,230,7,818,24.8,1048,31.8
2019,67,Washington,34,322,9.5,752,22.1,1074,31.6
2019,68,North Dakota State,33,218,6.6,823,24.9,1041,31.5
2018,1,North Carolina,35,492,14.1,995,28.4,1487,42.5
2018,2,Duke,33,447,13.5,935,28.3,1382,41.9
2018,3,New Mexico State,33,419,12.7,949,28.8,1368,41.5
2018,4,Texas A&M,32,402,12.6,920,28.8,1322,41.3
2018,5,Michigan State,33,365,11.1,983,29.8,1348,40.8
2018,6,Wichita State,32,389,12.2,907,28.3,1296,40.5
2018,7,Gonzaga,34,376,11.1,981,28.9,1357,39.9
2018,8,Cincinnati,33,435,13.2,855,25.9,1290,39.1
2018,9,Buffalo,34,408,12,918,27,1326,39
2018,10,South Dakota State,34,302,8.9,1023,30.1,1325,39
2018,11,Lipscomb,32,340,10.6,907,28.3,1247,39
2018,12,Houston,32,382,11.9,862,26.9,1244,38.9
2018,13,Kentucky,33,400,12.1,880,26.7,1280,38.8
2018,14,UCLA,32,330,10.3,911,28.5,1241,38.8
2018,15,Xavier,33,322,9.8,945,28.6,1267,38.4
2018,16,Oklahoma,31,322,10.4,864,27.9,1186,38.3
2018,17,Seton Hall,32,390,12.2,832,26,1222,38.2
2018,8,Auburn,32,388,12.1,833,26,1221,38.2
2018,19,Iowa,33,391,11.8,867,26.3,1258,38.1
2018,20,Long Island University,34,364,10.7,931,27.4,1295,38.1
2018,21,Florida State,31,363,11.7,816,26.3,1179,38
2018,22,North Carolina Central,34,395,11.6,898,26.4,1293,38
2018,23,Pennsylvania,31,275,8.9,901,29.1,1176,37.9
2018,24,West Virginia,34,476,14,812,23.9,1288,37.9
2018,25,San Diego State,32,355,11.1,851,26.6,1206,37.7
2018,26,Syracuse,33,399,12.1,836,25.3,1235,37.4
2018,27,UNC Greensboro,34,406,11.9,857,25.2,1263,37.1
2018,28,Montana,33,394,11.9,831,25.2,1225,37.1
2018,29,Murray State,31,327,10.5,823,26.5,1150,37.1
2018,30,Missouri,32,327,10.2,858,26.8,1185,37
2018,31,Bucknell,34,318,9.4,935,27.5,1253,36.9
2018,32,Arizona,34,341,10,905,26.6,1246,36.6
2018,33,Ohio State,32,311,9.7,861,26.9,1172,36.6
2018,34,TCU,32,360,11.3,806,25.2,1166,36.4
2018,35,Alabama,34,341,10,893,26.3,1234,36.3
2018,26,Wright State,34,346,10.2,888,26.1,1234,36.3
2018,27,Creighton,32,232,7.3,929,29,1161,36.3
2018,38,Marshall,34,276,8.1,956,28.1,1232,36.2
2018,39,Tennessee,32,367,11.5,792,24.8,1159,36.2
2018,40,Texas Southern,34,350,10.3,880,25.9,1230,36.2
2018,41,Nevada,34,322,9.5,903,26.6,1225,36
2018,42,Texas Tech,33,363,11,823,24.9,1186,35.9
2018,43,Providence,34,364,10.7,857,25.2,1221,35.9
2018,44,North Carolina A&T,34,341,10,877,25.8,1218,35.8
2018,45,Stephen F. Austin,34,397,11.7,820,24.1,1217,35.8
2018,46,Texas,33,349,10.6,832,25.2,1181,35.8
2018,47,NC State,32,390,12.2,752,23.5,1142,35.7
2018,48,Villanova,34,319,9.4,891,26.2,1210,35.6
2018,49,St. Bonaventure,32,331,10.3,807,25.2,1138,35.6
2018,50,Clemson,32,287,9,848,26.5,1135,35.5
2018,51,Arizona State,31,307,9.9,785,25.3,1092,35.2
2018,52,Kansas,34,325,9.6,872,25.6,1197,35.2
2018,53,CSU Fullerton,31,275,8.9,814,26.3,1089,35.1
2018,54,Florida,32,345,10.8,779,24.3,1124,35.1
2018,55,Purdue,34,287,8.4,904,26.6,1191,35
2018,56,Miami,31,309,10,771,24.9,1080,34.8
2018,57,UMBC,34,338,9.9,846,24.9,1184,34.8
2018,58,Arkansas,34,346,10.2,836,24.6,1182,34.8
2018,59,Radford,34,393,11.6,785,23.1,1178,34.6
2018,60,Rhode Island,31,350,11.3,714,23,1064,34.3
2018,61,Georgia State,33,295,8.9,830,25.2,1125,34.1
2018,62,Butler,33,304,9.2,818,24.8,1122,34
2018,63,Iona,33,281,8.5,834,25.3,1115,33.8
2018,64,Michigan,35,300,8.6,866,24.7,1166,33.3
2018,65,Charleston,33,280,8.5,809,24.5,1089,33
2018,66,Virginia Tech,32,236,7.4,820,25.6,1056,33
2018,67,Davidson,31,215,6.9,803,25.9,1018,32.8
2018,68,Virginia,33,277,8.4,801,24.3,1078,32.7
2018,69,Loyola Chicago,33,209,6.3,858,26,1067,32.3
2018,70,Kansas State,33,270,8.2,739,22.4,1009,30.6
2017,1,North Carolina,34,537,15.8,942,27.7,1479,43.5
2017,2,Wichita State,34,406,11.9,982,28.9,1388,40.8
2017,3,Kent State,35,524,15,892,25.5,1416,40.5
2017,4,Gonzaga,33,309,9.4,1021,30.9,1330,40.3
2017,5,Kentucky,34,428,12.6,938,27.6,1366,40.2
2017,6,Minnesota,33,374,11.3,943,28.6,1317,39.9
2017,7,New Mexico State,33,427,12.9,885,26.8,1312,39.8
2017,8,Louisville,32,426,13.3,844,26.4,1270,39.7
2017,9,Seton Hall,32,418,13.1,848,26.5,1266,39.6
2017,10,UCLA,33,322,9.8,972,29.5,1294,39.2
2017,11,Nevada,34,376,11.1,947,27.9,1323,38.9
2017,12,Kansas,32,385,12,858,26.8,1243,38.8
2017,12,North Carolina Central,33,388,11.8,893,27.1,1281,38.8
2017,14,SMU,34,406,11.9,898,26.4,1304,38.4
2017,15,Baylor,32,412,12.9,805,25.2,1217,38
2017,16,Purdue,32,315,9.8,899,28.1,1214,37.9
2017,17,Florida State,33,389,11.8,856,25.9,1245,37.7
2017,18,Florida Gulf Coast,33,372,11.3,871,26.4,1243,37.7
2017,19,Northern Kentucky,34,378,11.1,901,26.5,1279,37.6
2017,20,Xavier,34,415,12.2,863,25.4,1278,37.6
2017,21,Rhode Island,33,392,11.9,843,25.5,1235,37.4
2017,22,Winthrop,32,313,9.8,884,27.6,1197,37.4
2017,23,Florida,32,370,11.6,825,25.8,1195,37.3
2017,24,Wisconsin,34,420,12.4,849,25,1269,37.3
2017,25,West Virginia,34,487,14.3,781,23,1268,37.3
2017,26,Cincinnati,34,421,12.4,843,24.8,1264,37.2
2017,27,Troy,36,396,11,934,25.9,1330,36.9
2017,28,Arizona,34,350,10.3,900,26.5,1250,36.8
2017,29,Wake Forest,32,342,10.7,834,26.1,1176,36.8
2017,30,Oklahoma State,32,438,13.7,737,23,1175,36.7
2017,31,Michigan State,33,313,9.5,898,27.2,1211,36.7
2017,32,VCU,34,375,11,871,25.6,1246,36.6
2017,33,East Tennessee State,34,344,10.1,893,26.3,1237,36.4
2017,34,Oregon,34,355,10.4,882,25.9,1237,36.4
2017,35,Duke,35,366,10.5,905,25.9,1271,36.3
2017,36,South Carolina,32,401,12.5,760,23.8,1161,36.3
2017,37,Arkansas,34,385,11.3,848,24.9,1233,36.3
2017,38,Northwestern,34,366,10.8,865,25.4,1231,36.2
2017,39,USC,33,356,10.8,835,25.3,1191,36.1
2017,40,Miami,32,354,11.1,799,25,1153,36
2017,41,Iona,34,326,9.6,898,26.4,1224,36
2017,42,North Dakota,31,288,9.3,826,26.6,1114,35.9
2017,43,Jacksonville State,34,351,10.3,870,25.6,1221,35.9
2017,44,UNC Wilmington,34,408,12,813,23.9,1221,35.9
2017,45,Maryland,32,344,10.8,804,25.1,1148,35.9
2017,46,New Orleans,31,376,12.1,736,23.7,1112,35.9
2017,47,UC Davis,34,349,10.3,863,25.4,1212,35.6
2017,48,Saint Mary's,32,308,9.6,832,26,1140,35.6
2017,49,Middle Tennessee,34,337,9.9,871,25.6,1208,35.5
2017,50,Texas Southern,34,395,11.6,804,23.6,1199,35.3
2017,51,South Dakota State,34,307,9,883,26,1190,35
2017,52,Iowa State,33,308,9.3,845,25.6,1153,34.9
2017,53,Creighton,34,278,8.2,908,26.7,1186,34.9
2017,54,Vanderbilt,34,279,8.2,899,26.4,1178,34.6
2017,55,Dayton,31,267,8.6,801,25.8,1068,34.5
2017,56,Bucknell,34,293,8.6,878,25.8,1171,34.4
2017,57,Vermont,34,318,9.4,846,24.9,1164,34.2
2017,58,Notre Dame,34,317,9.3,831,24.4,1148,33.8
2017,59,Providence,32,287,9,786,24.6,1073,33.5
2017,60,Princeton,29,240,8.3,729,25.1,969,33.4
2017,61,Villanova,34,291,8.6,843,24.8,1134,33.4
2017,62,Marquette,31,274,8.8,757,24.4,1031,33.3
2017,63,Virginia,32,282,8.8,772,24.1,1054,32.9
2017,64,Kansas State,33,314,9.5,767,23.2,1081,32.8
2017,65,Virginia Tech,32,234,7.3,807,25.2,1041,32.5
2017,66,Butler,31,272,8.8,721,23.3,993,32
2017,67,Mount St. Mary's,34,260,7.6,769,22.6,1029,30.3
2017,68,Michigan,35,263,7.5,766,21.9,1029,29.4
2016,1,Colorado,33,437,13.2,963,29.2,1400,42.4
2016,2,Michigan State,33,407,12.3,976,29.6,1383,41.9
2016,3,Hampton,31,438,14.1,853,27.5,1291,41.6
2016,4,Purdue,33,390,11.8,971,29.4,1361,41.2
2016,5,Xavier,32,418,13.1,894,27.9,1312,41
2016,6,North Carolina,34,477,14,916,26.9,1393,41
2016,7,Yale,28,379,13.5,752,26.9,1131,40.4
2016,8,Arizona,33,384,11.6,944,28.6,1328,40.2
2016,9,Florida Gulf Coast,33,392,11.9,935,28.3,1327,40.2
2016,10,Seton Hall,33,425,12.9,896,27.2,1321,40
2016,11,California,33,374,11.3,945,28.6,1319,40
2016,12,Gonzaga,33,350,10.6,957,29,1307,39.6
2016,13,Stony Brook,32,400,12.5,866,27.1,1266,39.6
2016,14,USC,33,396,12,906,27.5,1302,39.5
2016,15,Cincinnati,32,432,13.5,828,25.9,1260,39.4
2016,16,West Virginia,34,541,15.9,791,23.3,1332,39.2
2016,17,Buffalo,34,417,12.3,914,26.9,1331,39.1
2016,18,Kentucky,33,431,13.1,852,25.8,1283,38.9
2016,19,Green Bay,35,451,12.9,909,26,1360,38.9
2016,20,Texas A&M,33,419,12.7,863,26.2,1282,38.8
2016,21,Oklahoma,32,343,10.7,899,28.1,1242,38.8
2016,22,Saint Joseph's,33,340,10.3,937,28.4,1277,38.7
2016,23,Dayton,32,317,9.9,919,28.7,1236,38.6
2016,24,Vanderbilt,32,304,9.5,930,29.1,1234,38.6
2016,25,Iowa,31,369,11.9,821,26.5,1190,38.4
2016,26,CSU Bakersfield,32,401,12.5,825,25.8,1226,38.3
2016,27,Pittsburgh,32,410,12.8,812,25.4,1222,38.2
2016,28,South Dakota State,33,370,11.2,881,26.7,1251,37.9
2016,29,UNC Asheville,33,384,11.6,863,26.2,1247,37.8
2016,30,Kansas,34,361,10.6,922,27.1,1283,37.7
2016,31,UNC Wilmington,32,384,12,819,25.6,1203,37.6
2016,32,Fresno State,34,404,11.9,874,25.7,1278,37.6
2016,33,VCU,33,413,12.5,824,25,1237,37.5
2016,34,Weber State,34,291,8.6,983,28.9,1274,37.5
2016,35,Wichita State,32,373,11.7,826,25.8,1199,37.5
2016,36,Hawai'i,32,342,10.7,856,26.8,1198,37.4
2016,37,Baylor,33,453,13.7,781,23.7,1234,37.4
2016,38,Indiana,32,385,12,811,25.3,1196,37.4
2016,39,Utah,34,328,9.6,942,27.7,1270,37.4
2016,40,Middle Tennessee,33,341,10.3,879,26.6,1220,37
2016,41,Iona,32,339,10.6,842,26.3,1181,36.9
2016,42,Austin Peay,35,407,11.6,882,25.2,1289,36.8
2016,43,Temple,32,358,11.2,818,25.6,1176,36.8
2016,44,Providence,33,385,11.7,822,24.9,1207,36.6
2016,45,UConn,33,319,9.7,887,26.9,1206,36.5
2016,46,Butler,31,354,11.4,775,25,1129,36.4
2016,47,Duke,33,404,12.2,795,24.1,1199,36.3
2016,48,Oregon,34,399,11.7,830,24.4,1229,36.1
2016,49,Iowa State,32,291,9.1,863,27,1154,36.1
2016,50,Notre Dame,32,349,10.9,805,25.2,1154,36.1
2016,51,Southern,34,356,10.5,869,25.6,1225,36
2016,52,Chattanooga,34,372,10.9,846,24.9,1218,35.8
2016,53,Villanova,34,315,9.3,896,26.4,1211,35.6
2016,54,Syracuse,32,378,11.8,759,23.7,1137,35.5
2016,55,Maryland,33,304,9.2,867,26.3,1171,35.5
2016,56,Stephen F. Austin,32,380,11.9,750,23.4,1130,35.3
2016,57,Tulsa,31,313,10.1,773,24.9,1086,35
2016,58,Wisconsin,32,366,11.4,751,23.5,1117,34.9
2016,59,Miami,32,310,9.7,802,25.1,1112,34.8
2016,60,Oregon State,31,330,10.6,743,24,1073,34.6
2016,61,Texas,32,352,11,753,23.5,1105,34.5
2016,62,Texas Tech,31,320,10.3,739,23.8,1059,34.2
2016,63,Little Rock,32,293,9.2,788,24.6,1081,33.8
2016,64,Fairleigh Dickinson,32,338,10.6,736,23,1074,33.6
2016,65,Michigan,34,267,7.9,822,24.2,1089,32
2016,66,Virginia,33,296,9,756,22.9,1052,31.9
2016,67,Holy Cross,33,269,8.2,725,22,994,30.1
2016,68,Northern Iowa,34,183,5.4,839,24.7,1022,30.1
2015,1,North Carolina,35,488,13.9,948,27.1,1436,41
2015,2,Coastal Carolina,33,440,13.3,873,26.5,1313,39.8
2015,3,Texas,33,410,12.4,900,27.3,1310,39.7
2015,4,LSU,32,388,12.1,866,27.1,1254,39.2
2015,5,Baylor,33,485,14.7,808,24.5,1293,39.2
2015,6,BYU,34,415,12.2,895,26.3,1310,38.5
2015,7,Buffalo,32,412,12.9,818,25.6,1230,38.4
2015,8,Kentucky,34,439,12.9,859,25.3,1298,38.2
2015,9,Louisville,32,413,12.9,808,25.3,1221,38.2
2015,10,Oklahoma,32,351,11,868,27.1,1219,38.1
2015,11,Georgia,32,348,10.9,868,27.1,1216,38
2015,12,UCLA,33,406,12.3,847,25.7,1253,38
2015,13,Kansas,34,402,11.8,888,26.1,1290,37.9
2015,14,Gonzaga,34,347,10.2,940,27.6,1287,37.9
2015,15,NC State,33,400,12.1,849,25.7,1249,37.8
2015,16,Valparaiso,33,386,11.7,859,26,1245,37.7
2015,17,Iowa,32,401,12.5,805,25.2,1206,37.7
2015,18,Michigan State,34,390,11.5,891,26.2,1281,37.7
2015,19,Ole Miss,32,397,12.4,805,25.2,1202,37.6
2015,20,Duke,33,401,12.2,831,25.2,1232,37.3
2015,21,Arizona,34,368,10.8,898,26.4,1266,37.2
2015,22,Hampton,33,404,12.2,820,24.8,1224,37.1
2015,23,West Virginia,32,539,16.8,638,19.9,1177,36.8
2015,24,Butler,32,390,12.2,785,24.5,1175,36.7
2015,25,SMU,33,378,11.5,833,25.2,1211,36.7
2015,26,UAB,34,403,11.9,841,24.7,1244,36.6
2015,27,Oregon,34,359,10.6,877,25.8,1236,36.4
2015,28,Purdue,33,388,11.8,810,24.5,1198,36.3
2015,29,Virginia,32,329,10.3,829,25.9,1158,36.2
2015,30,Providence,33,398,12.1,791,24,1189,36
2015,31,Indiana,33,395,12,792,24,1187,36
2015,32,Davidson,31,325,10.5,789,25.5,1114,35.9
2015,33,Iowa State,33,314,9.5,870,26.4,1184,35.9
2015,34,Ohio State,33,372,11.3,811,24.6,1183,35.8
2015,35,Arkansas,34,442,13,774,22.8,1216,35.8
2015,36,Wichita State,32,380,11.9,758,23.7,1138,35.6
2015,37,New Mexico State,33,414,12.5,756,22.9,1170,35.5
2015,38,VCU,35,431,12.3,809,23.1,1240,35.4
2015,39,UC Irvine,33,320,9.7,849,25.7,1169,35.4
2015,40,St. John's,32,329,10.3,803,25.1,1132,35.4
2015,41,San Diego State,34,413,12.1,784,23.1,1197,35.2
2015,42,Georgetown,31,347,11.2,742,23.9,1089,35.1
2015,43,Maryland,33,302,9.2,855,25.9,1157,35.1
2015,44,Utah,32,296,9.3,821,25.7,1117,34.9
2015,45,Xavier,34,340,10,844,24.8,1184,34.8
2015,46,Stephen F. Austin,33,402,12.2,745,22.6,1147,34.8
2015,47,North Florida,34,326,9.6,851,25,1177,34.6
2015,48,Texas Southern,34,386,11.4,788,23.2,1174,34.5
2015,49,Harvard,29,304,10.5,695,24,999,34.4
2015,50,Villanova,34,351,10.3,819,24.1,1170,34.4
2015,51,Cincinnati,32,351,11,744,23.3,1095,34.2
2015,52,Eastern Washington,34,341,10,814,23.9,1155,34
2015,53,Wisconsin,34,322,9.5,823,24.2,1145,33.7
2015,54,Albany,32,320,10,756,23.6,1076,33.6
2015,55,North Dakota State,32,271,8.5,803,25.1,1074,33.6
2015,56,Robert Morris,33,344,10.4,759,23,1103,33.4
2015,57,Belmont,32,301,9.4,763,23.8,1064,33.3
2015,58,Northeastern,34,284,8.4,843,24.8,1127,33.1
2015,59,Boise State,33,286,8.7,800,24.2,1086,32.9
2015,60,Georgia State,33,309,9.4,773,23.4,1082,32.8
2015,61,Notre Dame,34,283,8.3,831,24.4,1114,32.8
2015,62,Oklahoma State,31,278,9,730,23.5,1008,32.5
2015,63,Wofford,34,310,9.1,792,23.3,1102,32.4
2015,64,Manhattan,32,333,10.4,691,21.6,1024,32
2015,65,Dayton,33,245,7.4,796,24.1,1041,31.5
2015,66,Lafayette,32,272,8.5,720,22.5,992,31
2015,67,Northern Iowa,33,239,7.2,778,23.6,1017,30.8
2015,68,Wyoming,34,212,6.2,813,23.9,1025,30.1
2014,1,Texas,33,497,15.1,881,26.7,1378,41.8
2014,2,Kentucky,33,486,14.7,877,26.6,1363,41.3
2014,3,BYU,34,451,13.3,949,27.9,1400,41.2
2014,4,Iowa,32,440,13.8,862,26.9,1302,40.7
2014,5,North Carolina,32,450,14.1,822,25.7,1272,39.8
2014,6,Coastal Carolina,33,429,13,879,26.6,1308,39.6
2014,7,Arizona,34,428,12.6,894,26.3,1322,38.9
2014,8,Tennessee,33,452,13.7,829,25.1,1281,38.8
2014,9,Iowa State,33,337,10.2,943,28.6,1280,38.8
2014,10,Baylor,35,500,14.3,854,24.4,1354,38.7
2014,11,Wichita State,34,404,11.9,909,26.7,1313,38.6
2014,12,UMass,32,390,12.2,844,26.4,1234,38.6
2014,13,New Mexico,33,351,10.6,908,27.5,1259,38.2
2014,14,Kansas,33,389,11.8,869,26.3,1258,38.1
2014,15,Mercer,34,397,11.7,895,26.3,1292,38
2014,16,Louisiana,33,451,13.7,802,24.3,1253,38
2014,17,Louisville,34,466,13.7,822,24.2,1288,37.9
2014,18,VCU,33,468,14.2,782,23.7,1250,37.9
2014,19,San Diego State,33,434,13.2,815,24.7,1249,37.8
2014,20,Oklahoma,32,380,11.9,825,25.8,1205,37.7
2014,21,Memphis,32,404,12.6,800,25,1204,37.6
2014,22,Manhattan,32,408,12.8,795,24.8,1203,37.6
2014,23,Colorado,34,394,11.6,882,25.9,1276,37.5
2014,24,George Washington,32,378,11.8,818,25.6,1196,37.4
2014,25,New Mexico State,35,414,11.8,891,25.5,1305,37.3
2014,26,Villanova,32,361,11.3,826,25.8,1187,37.1
2014,27,Michigan State,33,362,11,860,26.1,1222,37
2014,28,Texas Southern,33,375,11.4,844,25.6,1219,36.9
2014,29,Providence,34,423,12.4,829,24.4,1252,36.8
2014,30,Delaware,34,378,11.1,862,25.4,1240,36.5
2014,31,Tulsa,33,356,10.8,842,25.5,1198,36.3
2014,32,Saint Louis,32,327,10.2,833,26,1160,36.3
2014,33,Pittsburgh,34,413,12.1,814,23.9,1227,36.1
2014,34,Cincinnati,33,441,13.4,749,22.7,1190,36.1
2014,35,Kansas State,32,397,12.4,755,23.6,1152,36
2014,36,Xavier,33,368,11.2,814,24.7,1182,35.8
2014,37,Saint Joseph's,32,310,9.7,835,26.1,1145,35.8
2014,38,Gonzaga,34,325,9.6,890,26.2,1215,35.7
2014,39,UCLA,34,343,10.1,869,25.6,1212,35.6
2014,40,Arizona State,32,270,8.4,870,27.2,1140,35.6
2014,41,Florida,33,384,11.6,791,24,1175,35.6
2014,42,North Carolina Central,33,390,11.8,783,23.7,1173,35.5
2014,43,Virginia,33,359,10.9,811,24.6,1170,35.5
2014,44,UConn,34,343,10.1,860,25.3,1203,35.4
2014,45,Dayton,33,384,11.6,781,23.7,1165,35.3
2014,46,Syracuse,32,422,13.2,706,22.1,1128,35.3
2014,47,Oklahoma State,33,315,9.5,848,25.7,1163,35.2
2014,48,Western Michigan,32,315,9.8,803,25.1,1118,34.9
2014,49,Stanford,33,319,9.7,831,25.2,1150,34.8
2014,50,Albany,32,331,10.3,775,24.2,1106,34.6
2014,51,Duke,33,394,11.9,744,22.5,1138,34.5
2014,52,Weber State,30,252,8.4,781,26,1033,34.4
2014,53,Creighton,33,279,8.5,855,25.9,1134,34.4
2014,54,NC State,34,406,11.9,761,22.4,1167,34.3
2014,55,Oregon,32,345,10.8,752,23.5,1097,34.3
2014,56,Harvard,30,318,10.6,709,23.6,1027,34.2
2014,57,Ohio State,34,343,10.1,816,24,1159,34.1
2014,58,Stephen F. Austin,33,429,13,686,20.8,1115,33.8
2014,59,Milwaukee,34,330,9.7,815,24,1145,33.7
2014,60,Nebraska,31,273,8.8,761,24.5,1034,33.4
2014,61,Wofford,32,344,10.8,720,22.5,1064,33.3
2014,62,Wisconsin,33,290,8.8,805,24.4,1095,33.2
2014,63,North Dakota State,31,294,9.5,722,23.3,1016,32.8
2014,64,Cal Poly,32,354,11.1,680,21.3,1034,32.3
2014,65,Mount St. Mary's,32,322,10.1,708,22.1,1030,32.2
2014,66,Michigan,32,279,8.7,742,23.2,1021,31.9
2014,67,American,32,228,7.1,734,22.9,962,30.1
2014,68,Eastern Kentucky,33,235,7.1,630,19.1,865,26.2
2013,1,Missouri,33,451,13.7,916,27.8,1367,41.4
2013,2,Colorado State,33,474,14.4,860,26.1,1334,40.4
2013,3,UNLV,34,406,11.9,958,28.2,1364,40.1
2013,4,Cincinnati,33,474,14.4,846,25.6,1320,40
2013,5,Northwestern State,31,429,13.8,790,25.5,1219,39.3
2013,6,North Carolina,33,456,13.8,839,25.4,1295,39.2
2013,7,Kansas,34,373,11,957,28.1,1330,39.1
2013,8,Minnesota,32,477,14.9,766,23.9,1243,38.8
2013,9,Ole Miss,33,436,13.2,844,25.6,1280,38.8
2013,10,Syracuse,35,509,14.5,847,24.2,1356,38.7
2013,11,Iowa State,33,405,12.3,873,26.5,1278,38.7
2013,12,Indiana,33,411,12.5,863,26.2,1274,38.6
2013,13,Wichita State,34,447,13.1,860,25.3,1307,38.4
2013,14,Akron,32,416,13,798,24.9,1214,37.9
2013,15,Memphis,34,417,12.3,868,25.5,1285,37.8
2013,16,New Mexico State,34,408,12,870,25.6,1278,37.6
2013,17,Louisville,34,463,13.6,812,23.9,1275,37.5
2013,18,Oregon,34,416,12.2,856,25.2,1272,37.4
2013,19,Gonzaga,33,377,11.4,854,25.9,1231,37.3
2013,20,Michigan State,33,379,11.5,851,25.8,1230,37.3
2013,21,California,31,340,11,813,26.2,1153,37.2
2013,22,Colorado,32,370,11.6,820,25.6,1190,37.2
2013,23,Saint Mary's,33,399,12.1,824,25,1223,37.1
2013,24,Wisconsin,33,386,11.7,833,25.2,1219,36.9
2013,25,San Diego State,32,351,11,828,25.9,1179,36.8
2013,26,NC State,34,389,11.4,863,25.4,1252,36.8
2013,27,Middle Tennessee,33,401,12.2,814,24.7,1215,36.8
2013,28,Oklahoma,31,369,11.9,770,24.8,1139,36.7
2013,29,Butler,34,397,11.7,849,25,1246,36.6
2013,30,Florida Gulf Coast,34,390,11.5,855,25.1,1245,36.6
2013,31,Oklahoma State,32,348,10.9,817,25.5,1165,36.4
2013,32,UCLA,34,368,10.8,866,25.5,1234,36.3
2013,33,Villanova,33,368,11.2,829,25.1,1197,36.3
2013,34,Arizona,32,369,11.5,791,24.7,1160,36.3
2013,35,Notre Dame,34,378,11.1,854,25.1,1232,36.2
2013,36,Western Kentucky,35,423,12.1,843,24.1,1266,36.2
2013,37,Bucknell,33,299,9.1,894,27.1,1193,36.2
2013,38,Iona,33,381,11.5,808,24.5,1189,36
2013,39,Miami,32,319,10,825,25.8,1144,35.8
2013,40,Liberty,35,361,10.3,887,25.3,1248,35.7
2013,41,North Carolina A&T,35,376,10.7,864,24.7,1240,35.4
2013,42,Long Island University,33,388,11.8,780,23.6,1168,35.4
2013,43,Ohio State,32,340,10.6,792,24.8,1132,35.4
2013,44,Pittsburgh,32,414,12.9,717,22.4,1131,35.3
2013,45,Kansas State,34,455,13.4,744,21.9,1199,35.3
2013,46,Creighton,34,286,8.4,912,26.8,1198,35.2
2013,47,New Mexico,34,319,9.4,879,25.9,1198,35.2
2013,48,Southern,32,285,8.9,841,26.3,1126,35.2
2013,49,Michigan,33,352,10.7,807,24.5,1159,35.1
2013,50,Florida,32,335,10.5,788,24.6,1123,35.1
2013,51,Marquette,31,357,11.5,727,23.5,1084,35
2013,52,VCU,33,459,13.9,689,20.9,1148,34.8
2013,53,South Dakota State,34,323,9.5,858,25.2,1181,34.7
2013,54,Temple,32,363,11.3,740,23.1,1103,34.5
2013,55,Boise State,31,312,10.1,740,23.9,1052,33.9
2013,56,Davidson,33,299,9.1,817,24.8,1116,33.8
2013,57,Duke,32,309,9.7,773,24.2,1082,33.8
2013,58,Albany,34,335,9.9,807,23.7,1142,33.6
2013,59,Illinois,34,400,11.8,740,21.8,1140,33.5
2013,60,Georgetown,31,286,9.2,735,23.7,1021,32.9
2013,61,Valparaiso,33,295,8.9,791,24,1086,32.9
2013,62,Saint Louis,32,290,9.1,761,23.8,1051,32.8
2013,63,James Madison,34,340,10,772,22.7,1112,32.7
2013,64,Pacific,34,323,9.5,776,22.8,1099,32.3
2013,65,Belmont,32,302,9.4,729,22.8,1031,32.2
2013,66,La Salle,30,303,10.1,648,21.6,951,31.7
2013,67,Montana,31,237,7.6,729,23.5,966,31.2
2013,68,Harvard,28,205,7.3,618,22.1,823,29.4
2012,1,North Carolina,33,514,15.6,979,29.7,1493,45.2
2012,2,New Mexico State,35,511,14.6,899,25.7,1410,40.3
2012,3,Lamar,34,478,14.1,869,25.6,1347,39.6
2012,4,Kentucky,33,410,12.4,883,26.8,1293,39.2
2012,5,Davidson,32,402,12.6,844,26.4,1246,38.9
2012,6,Long Island University,33,392,11.9,883,26.8,1275,38.6
2012,7,BYU,33,362,11,908,27.5,1270,38.5
2012,8,West Virginia,32,481,15,748,23.4,1229,38.4
2012,9,Michigan State,33,392,11.9,870,26.4,1262,38.2
2012,10,Louisville,35,460,13.1,878,25.1,1338,38.2
2012,11,Wichita State,32,347,10.8,870,27.2,1217,38
2012,12,New Mexico,33,371,11.2,882,26.7,1253,38
2012,13,UConn,33,407,12.3,842,25.5,1249,37.8
2012,14,UNLV,34,396,11.6,889,26.1,1285,37.8
2012,15,Kansas State,31,441,14.2,714,23,1155,37.3
2012,16,NC State,34,413,12.1,851,25,1264,37.2
2012,17,Gonzaga,31,340,11,811,26.2,1151,37.1
2012,18,San Diego State,33,352,10.7,872,26.4,1224,37.1
2012,19,Mississippi Valley State,34,450,13.2,806,23.7,1256,36.9
2012,20,Florida State,32,379,11.8,802,25.1,1181,36.9
2012,21,Kansas,33,367,11.1,850,25.8,1217,36.9
2012,22,Ohio State,33,386,11.7,827,25.1,1213,36.8
2012,23,Southern Miss,33,458,13.9,754,22.8,1212,36.7
2012,24,Iowa State,32,347,10.8,828,25.9,1175,36.7
2012,25,Xavier,32,345,10.8,828,25.9,1173,36.7
2012,26,Saint Mary's,32,366,11.4,806,25.2,1172,36.6
2012,27,Duke,33,393,11.9,814,24.7,1207,36.6
2012,28,Baylor,34,415,12.2,825,24.3,1240,36.5
2012,29,Norfolk State,34,393,11.6,845,24.9,1238,36.4
2012,30,Georgetown,31,352,11.4,776,25,1128,36.4
2012,31,Belmont,34,391,11.5,844,24.8,1235,36.3
2012,32,Cincinnati,34,459,13.5,772,22.7,1231,36.2
2012,33,Texas,33,443,13.4,751,22.8,1194,36.2
2012,34,Creighton,33,314,9.5,879,26.6,1193,36.2
2012,35,Lehigh,33,362,11,823,24.9,1185,35.9
2012,36,Western Kentucky,33,413,12.5,771,23.4,1184,35.9
2012,37,Marquette,32,378,11.8,768,24,1146,35.8
2012,38,Colorado,34,335,9.9,880,25.9,1215,35.7
2012,39,Long Beach State,33,375,11.4,801,24.3,1176,35.6
2012,40,St. Bonaventure,30,338,11.3,726,24.2,1064,35.5
2012,41,Vermont,34,376,11.1,826,24.3,1202,35.4
2012,42,Loyola (MD),32,425,13.3,706,22.1,1131,35.3
2012,43,Syracuse,33,420,12.7,746,22.6,1166,35.3
2012,44,Alabama,32,346,10.8,780,24.4,1126,35.2
2012,45,Florida,33,378,11.5,782,23.7,1160,35.2
2012,46,Temple,31,327,10.5,759,24.5,1086,35
2012,47,Indiana,33,356,10.8,796,24.1,1152,34.9
2012,48,California,33,329,10,822,24.9,1151,34.9
2012,49,Ohio,34,433,12.7,750,22.1,1183,34.8
2012,50,Iona,32,345,10.8,767,24,1112,34.8
2012,51,UNC Asheville,33,367,11.1,779,23.6,1146,34.7
2012,52,South Dakota State,34,356,10.5,816,24,1172,34.5
2012,53,Memphis,34,322,9.5,848,24.9,1170,34.4
2012,54,Vanderbilt,33,342,10.4,792,24,1134,34.4
2012,55,South Florida,33,345,10.5,786,23.8,1131,34.3
2012,56,Detroit Mercy,35,418,11.9,774,22.1,1192,34.1
2012,57,Notre Dame,33,339,10.3,784,23.8,1123,34
2012,58,Wisconsin,33,320,9.7,795,24.1,1115,33.8
2012,59,VCU,34,421,12.4,724,21.3,1145,33.7
2012,60,Murray State,31,337,10.9,694,22.4,1031,33.3
2012,61,Purdue,33,372,11.3,718,21.8,1090,33
2012,62,Montana,31,281,9.1,742,23.9,1023,33
2012,63,Saint Louis,32,330,10.3,720,22.5,1050,32.8
2012,64,Harvard,30,254,8.5,724,24.1,978,32.6
2012,65,Virginia,31,251,8.1,756,24.4,1007,32.5
2012,66,Missouri,34,312,9.2,783,23,1095,32.2
2012,67,Colorado State,31,254,8.2,717,23.1,971,31.3
2012,68,Michigan,33,280,8.5,738,22.4,1018,30.8
2011,1,North Carolina,33,468,14.2,935,28.3,1403,42.5
2011,2,Long Island University,32,463,14.5,876,27.4,1339,41.8
2011,3,Texas,34,469,13.8,908,26.7,1377,40.5
2011,4,Old Dominion,33,511,15.5,815,24.7,1326,40.2
2011,5,Pittsburgh,32,455,14.2,820,25.6,1275,39.8
2011,6,UConn,35,505,14.4,880,25.1,1385,39.6
2011,7,Washington,33,463,14,835,25.3,1298,39.3
2011,8,Florida State,31,386,12.5,824,26.6,1210,39
2011,9,Oakland,34,434,12.8,893,26.3,1327,39
2011,10,BYU,34,394,11.6,923,27.1,1317,38.7
2011,11,Kansas,34,397,11.7,914,26.9,1311,38.6
2011,12,Duke,34,418,12.3,883,26,1301,38.3
2011,13,Kentucky,33,399,12.1,858,26,1257,38.1
2011,14,Tennessee,33,458,13.9,795,24.1,1253,38
2011,15,Kansas State,32,468,14.6,747,23.3,1215,38
2011,16,Syracuse,33,416,12.6,833,25.2,1249,37.8
2011,17,Georgia,32,396,12.4,811,25.3,1207,37.7
2011,18,Florida,33,432,13.1,806,24.4,1238,37.5
2011,19,Utah State,33,355,10.8,882,26.7,1237,37.5
2011,20,Morehead State,33,455,13.8,781,23.7,1236,37.5
2011,21,Gonzaga,33,374,11.3,861,26.1,1235,37.4
2011,22,West Virginia,31,446,14.4,714,23,1160,37.4
2011,23,San Diego State,34,429,12.6,843,24.8,1272,37.4
2011,24,UCLA,32,378,11.8,816,25.5,1194,37.3
2011,25,Villanova,32,392,12.3,796,24.9,1188,37.1
2011,26,Michigan State,33,392,11.9,828,25.1,1220,37
2011,27,Vanderbilt,33,359,10.9,860,26.1,1219,36.9
2011,28,Notre Dame,32,350,10.9,832,26,1182,36.9
2011,29,Louisville,34,428,12.6,815,24,1243,36.6
2011,30,Belmont,34,445,13.1,791,23.3,1236,36.4
2011,31,Texas A&M,32,400,12.5,761,23.8,1161,36.3
2011,32,Alabama State,34,449,13.2,783,23,1232,36.2
2011,33,Marquette,34,422,12.4,809,23.8,1231,36.2
2011,34,Temple,32,353,11,802,25.1,1155,36.1
2011,35,Boston University,34,408,12,816,24,1224,36
2011,36,Northern Colorado,31,367,11.8,749,24.2,1116,36
2011,37,UAB,30,345,11.5,735,24.5,1080,36
2011,38,UNC Asheville,32,385,12,766,23.9,1151,36
2011,39,Saint Peter's,33,375,11.4,806,24.4,1181,35.8
2011,40,Memphis,34,411,12.1,802,23.6,1213,35.7
2011,41,Hampton,32,358,11.2,783,24.5,1141,35.7
2011,42,Cincinnati,33,432,13.1,744,22.5,1176,35.6
2011,43,Xavier,31,317,10.2,783,25.3,1100,35.5
2011,44,Missouri,33,410,12.4,756,22.9,1166,35.3
2011,45,Purdue,32,353,11,774,24.2,1127,35.2
2011,46,UNLV,32,360,11.3,766,23.9,1126,35.2
2011,47,George Mason,32,339,10.6,784,24.5,1123,35.1
2011,48,UTSA,32,341,10.7,779,24.3,1120,35
2011,49,Clemson,32,367,11.5,750,23.4,1117,34.9
2011,50,Butler,32,346,10.8,770,24.1,1116,34.9
2011,51,Illinois,32,327,10.2,787,24.6,1114,34.8
2011,53,Indiana State,33,342,10.4,805,24.4,1147,34.8
2011,53,Princeton,31,307,9.9,770,24.8,1077,34.7
2011,54,Arizona,34,354,10.4,822,24.2,1176,34.6
2011,55,Ohio State,34,381,11.2,792,23.3,1173,34.5
2011,56,Akron,35,355,10.1,851,24.3,1206,34.5
2011,57,Bucknell,33,269,8.2,857,26,1126,34.1
2011,58,USC,33,335,10.2,787,23.8,1122,34
2011,59,Georgetown,31,312,10.1,733,23.6,1045,33.7
2011,60,Little Rock,35,370,10.6,801,22.9,1171,33.5
2011,61,Richmond,34,308,9.1,821,24.1,1129,33.2
2011,62,St. John's,32,349,10.9,699,21.8,1048,32.8
2011,63,UC Santa Barbara,31,269,8.7,743,24,1012,32.6
2011,64,Wofford,33,365,11.1,707,21.4,1072,32.5
2011,65,Wisconsin,31,327,10.5,667,21.5,994,32.1
2011,66,Michigan,33,273,8.3,784,23.8,1057,32
2011,67,VCU,34,372,10.9,717,21.1,1089,32
2011,68,Penn State,33,329,10,713,21.6,1042,31.6
2010,1,Texas,33,493,14.9,898,27.2,1391,42.2
2010,2,Wake Forest,29,424,14.6,789,27.2,1213,41.8
2010,3,Kentucky,33,476,14.4,893,27.1,1369,41.5
2010,4,Kansas,34,440,12.9,938,27.6,1378,40.5
2010,5,Georgia Tech,33,442,13.4,888,26.9,1330,40.3
2010,6,Morgan St,36,555,15.4,895,24.9,1450,40.3
2010,7,Xavier,32,400,12.5,883,27.6,1283,40.1
2010,8,Duke,33,484,14.7,813,24.6,1297,39.3
2010,9,Old Dominion,34,517,15.2,815,24,1332,39.2
2010,10,Baylor,32,392,12.3,860,26.9,1252,39.1
2010,11,Kansas State,33,500,15.2,789,23.9,1289,39.1
2010,12,Villanova,31,415,13.4,795,25.6,1210,39
2010,13,Michigan State,32,433,13.5,816,25.5,1249,39
2010,14,Winthrop,32,436,13.6,806,25.2,1242,38.8
2010,15,New Mexico,33,435,13.2,842,25.5,1277,38.7
2010,16,Oakland,34,466,13.7,846,24.9,1312,38.6
2010,17,Maryland,31,394,12.7,802,25.9,1196,38.6
2010,18,Washington,33,446,13.5,821,24.9,1267,38.4
2010,19,West Virginia,33,514,15.6,751,22.8,1265,38.3
2010,20,Siena,33,427,12.9,838,25.4,1265,38.3
2010,21,Arkansas-Pine Bluff,32,403,12.6,820,25.6,1223,38.2
2010,22,Syracuse,32,388,12.1,833,26,1221,38.2
2010,23,Gonzaga,32,341,10.7,880,27.5,1221,38.2
2010,24,Florida State,31,395,12.7,784,25.3,1179,38
2010,25,Sam Houston State,32,402,12.6,809,25.3,1211,37.8
2010,26,Ohio,35,421,12,891,25.5,1312,37.5
2010,27,BYU,34,348,10.2,922,27.1,1270,37.4
2010,28,Pittsburgh,32,396,12.4,797,24.9,1193,37.3
2010,29,Temple,33,370,11.2,859,26,1229,37.2
2010,30,Vermont,34,417,12.3,845,24.9,1262,37.1
2010,31,San Diego State,33,433,13.1,791,24,1224,37.1
2010,32,North Texas,32,345,10.8,839,26.2,1184,37
2010,33,Florida,33,435,13.2,785,23.8,1220,37
2010,34,Louisville,32,463,14.5,717,22.4,1180,36.9
2010,35,Saint Mary's,31,335,10.8,807,26,1142,36.8
2010,36,Tennessee,33,387,11.7,825,25,1212,36.7
2010,37,Clemson,31,402,13,735,23.7,1137,36.7
2010,38,Murray State,34,413,12.1,828,24.4,1241,36.5
2010,39,Texas A&M,32,379,11.8,789,24.7,1168,36.5
2010,40,Lehigh,32,326,10.2,842,26.3,1168,36.5
2010,41,East Tennessee State,34,430,12.6,807,23.7,1237,36.4
2010,42,Vanderbilt,32,351,11,813,25.4,1164,36.4
2010,43,UTEP,32,317,9.9,846,26.4,1163,36.3
2010,44,Oklahoma State,32,324,10.1,828,25.9,1152,36
2010,45,California,33,379,11.5,801,24.3,1180,35.8
2010,46,Notre Dame,34,386,11.4,826,24.3,1212,35.6
2010,47,Minnesota,33,359,10.9,814,24.7,1173,35.5
2010,48,New Mexico State,33,343,10.4,829,25.1,1172,35.5
2010,49,Utah State,34,352,10.4,855,25.1,1207,35.5
2010,50,Wofford,34,391,11.5,815,24,1206,35.5
2010,51,Missouri,32,415,13,717,22.4,1132,35.4
2010,52,Robert Morris,34,401,11.8,791,23.3,1192,35.1
2010,53,Cornell,31,323,10.4,735,23.7,1058,34.1
2010,54,Houston,34,431,12.7,724,21.3,1155,34
2010,55,UNLV,33,322,9.8,799,24.2,1121,34
2010,56,Georgetown,33,319,9.7,782,23.7,1101,33.4
2010,57,Ohio State,33,297,9,804,24.4,1101,33.4
2010,58,Purdue,32,333,10.4,733,22.9,1066,33.3
2010,59,Richmond,33,300,9.1,791,24,1091,33.1
2010,60,Butler,32,296,9.3,755,23.6,1051,32.8
2010,61,UC Santa Barbara,29,256,8.8,693,23.9,949,32.7
2010,62,Montana,31,272,8.8,739,23.8,1011,32.6
2010,63,Northern Iowa,32,305,9.5,734,22.9,1039,32.5
2010,64,Wisconsin,31,302,9.7,703,22.7,1005,32.4
2010,65,Marquette,33,338,10.2,711,21.5,1049,31.8
2009,1,UConn,31,441,14.2,884,28.5,1325,42.7
2009,2,North Carolina,32,483,15.1,871,27.2,1354,42.3
2009,3,Radford,32,398,12.4,926,28.9,1324,41.4
2009,4,Washington,33,499,15.1,853,25.8,1352,41
2009,5,Wake Forest,30,380,12.7,849,28.3,1229,41
2009,6,Pittsburgh,32,477,14.9,795,24.8,1272,39.8
2009,7,Syracuse,35,452,12.9,936,26.7,1388,39.7
2009,8,Memphis,34,463,13.6,879,25.9,1342,39.5
2009,9,Xavier,32,386,12.1,877,27.4,1263,39.5
2009,10,LSU,33,450,13.6,852,25.8,1302,39.5
2009,11,Chattanooga,34,429,12.6,911,26.8,1340,39.4
2009,12,Oklahoma,32,388,12.1,867,27.1,1255,39.2
2009,13,Tennessee,33,474,14.4,814,24.7,1288,39
2009,14,Morehead State,34,469,13.8,855,25.1,1324,38.9
2009,15,Michigan State,32,447,14,798,24.9,1245,38.9
2009,16,Kansas,32,387,12.1,858,26.8,1245,38.9
2009,17,Texas,33,469,14.2,813,24.6,1282,38.8
2009,18,Mississippi State,35,393,11.2,956,27.3,1349,38.5
2009,19,West Virginia,34,517,15.2,786,23.1,1303,38.3
2009,20,Gonzaga,31,325,10.5,855,27.6,1180,38.1
2009,21,Morgan St,34,488,14.4,806,23.7,1294,38.1
2009,22,Louisville,33,415,12.6,839,25.4,1254,38
2009,23,Dayton,33,454,13.8,799,24.2,1253,38
2009,24,East Tennessee State,33,375,11.4,871,26.4,1246,37.8
2009,25,Villanova,33,403,12.2,832,25.2,1235,37.4
2009,26,CSU Northridge,30,393,13.1,725,24.2,1118,37.3
2009,27,Boston College,33,472,14.3,757,22.9,1229,37.2
2009,28,Texas A&M,32,403,12.6,783,24.5,1186,37.1
2009,29,Missouri,34,443,13,814,23.9,1257,37
2009,30,Western Kentucky,32,413,12.9,770,24.1,1183,37
2009,31,Temple,33,367,11.1,852,25.8,1219,36.9
2009,32,Clemson,31,441,14.2,704,22.7,1145,36.9
2009,33,Maryland,33,437,13.2,774,23.5,1211,36.7
2009,34,Duke,34,453,13.3,792,23.3,1245,36.6
2009,35,BYU,32,295,9.2,875,27.3,1170,36.6
2009,36,Siena,33,402,12.2,786,23.8,1188,36
2009,37,Florida State,34,395,11.6,825,24.3,1220,35.9
2009,38,USC,33,386,11.7,796,24.1,1182,35.8
2009,39,Alabama State,31,349,11.3,754,24.3,1103,35.6
2009,40,Marquette,33,399,12.1,775,23.5,1174,35.6
2009,41,North Dakota State,32,354,11.1,783,24.5,1137,35.5
2009,42,Cornell,30,304,10.1,761,25.4,1065,35.5
2009,43,Oklahoma State,33,333,10.1,838,25.4,1171,35.5
2009,44,Stephen F. Austin,31,297,9.6,795,25.6,1092,35.2
2009,45,Utah,33,263,8,895,27.1,1158,35.1
2009,46,Binghamton,31,351,11.3,730,23.5,1081,34.9
2009,47,Utah State,34,358,10.5,818,24.1,1176,34.6
2009,48,Minnesota,32,389,12.2,717,22.4,1106,34.6
2009,49,Cleveland State,35,415,11.9,790,22.6,1205,34.4
2009,50,Purdue,34,329,9.7,836,24.6,1165,34.3
2009,51,Portland State,32,384,12,711,22.2,1095,34.2
2009,52,Butler,31,315,10.2,745,24,1060,34.2
2009,53,VCU,33,352,10.7,769,23.3,1121,34
2009,54,Arizona,32,355,11.1,729,22.8,1084,33.9
2009,55,California,32,319,10,759,23.7,1078,33.7
2009,56,Northern Iowa,33,286,8.7,820,24.8,1106,33.5
2009,57,Akron,35,413,11.8,760,21.7,1173,33.5
2009,58,Robert Morris,34,345,10.1,788,23.2,1133,33.3
2009,49,Illinois,33,315,9.5,783,23.7,1098,33.3
2009,60,UCLA,33,379,11.5,711,21.5,1090,33
2009,61,American,31,295,9.5,727,23.5,1022,33
2009,62,Arizona State,33,278,8.4,756,22.9,1034,31.3
2009,63,Wisconsin,31,305,9.8,659,21.3,964,31.1
2009,64,Michigan,33,313,9.5,707,21.4,1020,30.9
2009,65,Ohio State,32,257,8,730,22.8,987,30.8
2008,1,North Carolina,34,534,15.7,969,28.5,1503,44.2
2008,2,UConn,32,433,13.5,908,28.4,1341,41.9
2008,3,Notre Dame,31,413,13.3,878,28.3,1291,41.6
2008,4,Kansas State,31,506,16.3,776,25,1282,41.4
2008,5,Mississippi State,32,391,12.2,917,28.7,1308,40.9
2008,6,Memphis,34,480,14.1,907,26.7,1387,40.8
2008,7,Texas A&M,34,405,11.9,931,27.4,1336,39.3
2008,8,BYU,34,357,10.5,969,28.5,1326,39
2008,9,Kansas,34,423,12.4,898,26.4,1321,38.9
2008,10,Stanford,33,435,13.2,847,25.7,1282,38.8
2008,11,Clemson,33,524,15.9,750,22.7,1274,38.6
2008,12,Saint Mary's,30,375,12.5,775,25.8,1150,38.3
2008,13,Georgia,33,444,13.5,820,24.8,1264,38.3
2008,14,UT Arlington,32,340,10.6,880,27.5,1220,38.1
2008,15,Tennessee,33,471,14.3,786,23.8,1257,38.1
2008,16,Indiana,32,372,11.6,845,26.4,1217,38
2008,17,Miami,32,412,12.9,804,25.1,1216,38
2008,18,Pittsburgh,35,508,14.5,815,23.3,1323,37.8
2008,19,Texas,34,438,12.9,847,24.9,1285,37.8
2008,20,Louisville,32,374,11.7,834,26.1,1208,37.8
2008,21,Gonzaga,32,358,11.2,843,26.3,1201,37.5
2008,22,Baylor,31,368,11.9,791,25.5,1159,37.4
2008,23,South Alabama,32,391,12.2,802,25.1,1193,37.3
2008,24,Michigan State,33,409,12.4,819,24.8,1228,37.2
2008,25,Duke,32,406,12.7,782,24.4,1188,37.1
2008,26,Davidson,32,375,11.7,812,25.4,1187,37.1
2008,27,Belmont,33,415,12.6,800,24.2,1215,36.8
2008,28,Arkansas,33,423,12.8,790,23.9,1213,36.8
2008,29,Marquette,33,442,13.4,766,23.2,1208,36.6
2008,30,CSU Fullerton,32,384,12,771,24.1,1155,36.1
2008,31,UCLA,34,430,12.6,797,23.4,1227,36.1
2008,32,Villanova,32,431,13.5,723,22.6,1154,36.1
2008,33,Xavier,33,372,11.3,818,24.8,1190,36.1
2008,34,Boise State,33,324,9.8,863,26.2,1187,36
2008,35,Oklahoma,33,375,11.4,812,24.6,1187,36
2008,36,Wisconsin,33,383,11.6,802,24.3,1185,35.9
2008,37,Oral Roberts,32,360,11.3,789,24.7,1149,35.9
2008,38,West Virginia,34,411,12.1,809,23.8,1220,35.9
2008,39,Winthrop,33,387,11.7,787,23.8,1174,35.6
2008,40,Vanderbilt,33,345,10.5,821,24.9,1166,35.3
2008,41,Georgetown,32,317,9.9,803,25.1,1120,35
2008,42,Western Kentucky,33,416,12.6,738,22.4,1154,35
2008,43,UNLV,32,340,10.6,773,24.2,1113,34.8
2008,44,George Mason,33,329,10,807,24.5,1136,34.4
2008,45,Portland State,32,368,11.5,730,22.8,1098,34.3
2008,46,UMBC,32,362,11.3,735,23,1097,34.3
2008,47,Oregon,31,316,10.2,741,23.9,1057,34.1
2008,48,Mount St. Mary's,32,323,10.1,766,23.9,1089,34
2008,49,Drake,32,380,11.9,708,22.1,1088,34
2008,50,Siena,32,375,11.7,710,22.2,1085,33.9
2008,51,Cornell,27,248,9.2,666,24.7,914,33.9
2008,52,Kentucky,30,292,9.7,720,24,1012,33.7
2008,53,USC,32,296,9.3,783,24.5,1079,33.7
2008,54,San Diego,34,364,10.7,782,23,1146,33.7
2008,55,Mississippi Valley State,32,374,11.7,699,21.8,1073,33.5
2008,56,Kent State,34,373,11,759,22.3,1132,33.3
2008,57,Temple,33,291,8.8,788,23.9,1079,32.7
2008,58,Purdue,32,360,11.3,684,21.4,1044,32.6
2008,59,Saint Joseph's,33,328,9.9,734,22.2,1062,32.2
2008,60,American,32,303,9.5,722,22.6,1025,32
2008,61,Austin Peay,34,344,10.1,728,21.4,1072,31.5
2008,62,Arizona,33,275,8.3,750,22.7,1025,31.1
2008,63,Butler,32,286,8.9,663,20.7,949,29.7
2008,64,Washington State,32,249,7.8,686,21.4,935,29.2
2007,1,North Carolina,34,456,13.4,928,27.3,1384,40.7
2007,2,Davidson,33,452,13.7,891,27,1343,40.7
2007,3,Kansas,34,444,13.1,929,27.3,1373,40.4
2007,4,Texas,33,462,14,864,26.2,1326,40.2
2007,5,North Texas,33,473,14.3,849,25.7,1322,40.1
2007,6,Memphis,33,488,14.8,829,25.1,1317,39.9
2007,7,Virginia,30,401,13.4,777,25.9,1178,39.3
2007,8,Maryland,32,404,12.6,830,25.9,1234,38.6
2007,9,Stanford,30,378,12.6,778,25.9,1156,38.5
2007,10,Notre Dame,31,393,12.7,796,25.7,1189,38.4
2007,11,Nevada,32,374,11.7,848,26.5,1222,38.2
2007,12,Niagara,33,484,14.7,773,23.4,1257,38.1
2007,13,New Mexico State,33,443,13.4,808,24.5,1251,37.9
2007,14,Gonzaga,33,347,10.5,894,27.1,1241,37.6
2007,15,Arizona,30,371,12.4,755,25.2,1126,37.5
2007,16,BYU,33,399,12.1,838,25.4,1237,37.5
2007,17,Belmont,32,358,11.2,840,26.3,1198,37.4
2007,18,Winthrop,32,394,12.3,804,25.1,1198,37.4
2007,19,Louisville,32,440,13.8,753,23.5,1193,37.3
2007,20,Florida,34,377,11.1,887,26.1,1264,37.2
2007,21,Marquette,33,476,14.4,746,22.6,1222,37
2007,22,Long Beach State,31,401,12.9,742,23.9,1143,36.9
2007,23,Florida A&M,34,435,12.8,814,23.9,1249,36.7
2007,24,Old Dominion,32,388,12.1,786,24.6,1174,36.7
2007,25,Villanova,32,428,13.4,739,23.1,1167,36.5
2007,26,Kentucky,32,345,10.8,821,25.7,1166,36.4
2007,27,Georgia Tech,31,424,13.7,701,22.6,1125,36.3
2007,28,Jackson State,34,463,13.6,768,22.6,1231,36.2
2007,29,Pittsburgh,34,415,12.2,801,23.6,1216,35.8
2007,30,Texas A&M,31,316,10.2,792,25.5,1108,35.7
2007,31,Ohio State,33,369,11.2,809,24.5,1178,35.7
2007,32,Texas A&M-CC,32,367,11.5,772,24.1,1139,35.6
2007,33,Tennessee,32,435,13.6,703,22,1138,35.6
2007,34,Arkansas,34,382,11.2,825,24.3,1207,35.5
2007,35,Oral Roberts,33,358,10.8,812,24.6,1170,35.5
2007,36,Michigan State,33,379,11.5,781,23.7,1160,35.2
2007,37,Illinois,34,428,12.6,766,22.5,1194,35.1
2007,38,Duke,32,361,11.3,762,23.8,1123,35.1
2007,39,Wisconsin,34,386,11.4,807,23.7,1193,35.1
2007,40,Oregon,33,403,12.2,754,22.8,1157,35.1
2007,41,Central Connecticut,33,395,12,758,23,1153,34.9
2007,42,UNLV,34,411,12.1,767,22.6,1178,34.6
2007,43,Boston College,31,367,11.8,707,22.8,1074,34.6
2007,44,USC,34,317,9.3,839,24.7,1156,34
2007,45,George Washington,31,375,12.1,679,21.9,1054,34
2007,46,Albany,32,352,11,735,23,1087,34
2007,47,Xavier,32,349,10.9,733,22.9,1082,33.8
2007,48,Virginia Tech,32,357,11.2,723,22.6,1080,33.8
2007,49,Vanderbilt,31,312,10.1,728,23.5,1040,33.5
2007,50,VCU,33,398,12.1,702,21.3,1100,33.3
2007,51,Indiana,30,350,11.7,649,21.6,999,33.3
2007,52,Georgetown,32,344,10.8,721,22.5,1065,33.3
2007,53,Pennsylvania,30,316,10.5,681,22.7,997,33.2
2007,54,Weber State,31,301,9.7,724,23.4,1025,33.1
2007,55,Purdue,32,358,11.2,696,21.8,1054,32.9
2007,56,UCLA,31,342,11,679,21.9,1021,32.9
2007,57,Creighton,32,329,10.3,720,22.5,1049,32.8
2007,58,Wright State,32,321,10,709,22.2,1030,32.2
2007,59,Holy Cross,33,375,11.4,686,20.8,1061,32.2
2007,60,Texas Tech,33,310,9.4,705,21.4,1015,30.8
2007,61,Miami (OH),32,257,8,717,22.4,974,30.4
2007,62,Washington State,32,251,7.8,721,22.5,972,30.4
2007,63,Southern Illinois,33,314,9.5,673,20.4,987,29.9
2007,64,Butler,33,298,9,687,20.8,985,29.8
2007,65,Eastern Kentucky,32,274,8.6,640,20,914,28.6
2006,1,UConn,30,489,16.3,860,28.7,1349,45
2006,2,Memphis,33,522,15.8,866,26.2,1388,42.1
2006,3,LSU,31,436,14.1,817,26.4,1253,40.4
2006,4,Texas,33,464,14.1,864,26.2,1328,40.2
2006,5,North Carolina,29,407,14,753,26,1160,40
2006,6,Kansas,32,422,13.2,847,26.5,1269,39.7
2006,7,Hampton,31,427,13.8,789,25.5,1216,39.2
2006,8,Pittsburgh,31,406,13.1,809,26.1,1215,39.2
2006,9,Davidson,30,379,12.6,792,26.4,1171,39
2006,10,Southern,31,406,13.1,797,25.7,1203,38.8
2006,11,Milwaukee,29,428,14.8,692,23.9,1120,38.6
2006,12,Nevada,32,403,12.6,829,25.9,1232,38.5
2006,13,Syracuse,34,465,13.7,838,24.6,1303,38.3
2006,14,George Washington,28,387,13.8,682,24.4,1069,38.2
2006,15,Washington,30,445,14.8,691,23,1136,37.9
2006,16,Iowa,33,363,11,886,26.8,1249,37.8
2006,17,Bradley,30,378,12.6,753,25.1,1131,37.7
2006,18,Gonzaga,30,378,12.6,750,25,1128,37.6
2006,19,Wichita State,32,385,12,811,25.3,1196,37.4
2006,20,Oral Roberts,32,428,13.4,763,23.8,1191,37.2
2006,21,Iona,30,400,13.3,711,23.7,1111,37
2006,22,Alabama,29,363,12.5,710,24.5,1073,37
2006,23,Murray State,30,393,13.1,715,23.8,1108,36.9
2006,24,Seton Hall,29,364,12.6,705,24.3,1069,36.9
2006,25,Oklahoma,28,410,14.6,615,22,1025,36.6
2006,26,Wisconsin,30,388,12.9,709,23.6,1097,36.6
2006,27,Winthrop,30,387,12.9,705,23.5,1092,36.4
2006,28,Villanova,29,391,13.5,660,22.8,1051,36.2
2006,29,UNC Wilmington,32,381,11.9,777,24.3,1158,36.2
2006,30,Marquette,30,364,12.1,720,24,1084,36.1
2006,31,Michigan State,33,367,11.1,821,24.9,1188,36
2006,32,Northwestern State,32,427,13.3,725,22.7,1152,36
2006,33,Illinois,31,386,12.5,730,23.5,1116,36
2006,34,Kentucky,33,418,12.7,766,23.2,1184,35.9
2006,35,Belmont,30,355,11.8,717,23.9,1072,35.7
2006,36,Montana,29,332,11.4,703,24.2,1035,35.7
2006,37,San Diego State,32,420,13.1,720,22.5,1140,35.6
2006,38,Pacific,31,306,9.9,792,25.5,1098,35.4
2006,39,Boston College,33,433,13.1,731,22.2,1164,35.3
2006,40,Florida,33,350,10.6,813,24.6,1163,35.2
2006,41,Xavier,31,328,10.6,762,24.6,1090,35.2
2006,42,Arkansas,31,378,12.2,708,22.8,1086,35
2006,43,George Mason,30,303,10.1,744,24.8,1047,34.9
2006,44,Arizona,31,422,13.6,648,20.9,1070,34.5
2006,45,Ohio State,30,303,10.1,718,23.9,1021,34
2006,46,Albany,31,341,11,712,23,1053,34
2006,47,South Alabama,30,339,11.3,679,22.6,1018,33.9
2006,48,Indiana,29,290,10,694,23.9,984,33.9
2006,49,Utah State,31,295,9.5,750,24.2,1045,33.7
2006,50,Northern Iowa,32,270,8.4,799,25,1069,33.4
2006,51,Kent State,33,363,11,738,22.4,1101,33.4
2006,52,Tennessee,28,323,11.5,611,21.8,934,33.4
2006,53,NC State,30,271,9,726,24.2,997,33.2
2006,54,UCLA,33,359,10.9,729,22.1,1088,33
2006,55,Duke,33,315,9.5,771,23.4,1086,32.9
2006,56,Southern Illinois,32,378,11.8,669,20.9,1047,32.7
2006,57,Monmouth,32,283,8.8,762,23.8,1045,32.7
2006,58,Georgetown,30,321,10.7,657,21.9,978,32.6
2006,59,California,30,292,9.7,684,22.8,976,32.5
2006,60,Bucknell,30,289,9.6,681,22.7,970,32.3
2006,61,Pennsylvania,28,291,10.4,607,21.7,898,32.1
2006,62,Texas A&M,29,301,10.4,618,21.3,919,31.7
2006,63,UAB,30,324,10.8,609,20.3,933,31.1
2006,64,West Virginia,30,238,7.9,602,20.1,840,28
2006,65,Air Force,30,203,6.8,545,18.2,748,24.9
2005,1,UConn,29,455,15.7,883,30.4,1338,46.1
2005,2,Chattanooga,36,498,13.8,1010,28.1,1508,41.9
2005,3,Cincinnati,31,446,14.4,839,27.1,1285,41.5
2005,4,Mississippi State,32,464,14.5,847,26.5,1311,41
2005,5,Niagara,29,460,15.9,724,25,1184,40.8
2005,6,North Carolina,31,427,13.8,823,26.5,1250,40.3
2005,7,Wake Forest,31,433,14,796,25.7,1229,39.6
2005,8,Nevada,30,367,12.2,822,27.4,1189,39.6
2005,9,Texas,30,405,13.5,783,26.1,1188,39.6
2005,10,Georgia Tech,30,383,12.8,801,26.7,1184,39.5
2005,11,Louisville,33,432,13.1,866,26.2,1298,39.3
2005,12,Charlotte,28,408,14.6,675,24.1,1083,38.7
2005,13,Duke,30,405,13.5,748,24.9,1153,38.4
2005,14,Pittsburgh,28,404,14.4,669,23.9,1073,38.3
2005,15,Gonzaga,29,340,11.7,767,26.4,1107,38.2
2005,16,Syracuse,33,456,13.8,797,24.2,1253,38
2005,17,Vermont,30,361,12,776,25.9,1137,37.9
2005,18,Boston College,28,401,14.3,657,23.5,1058,37.8
2005,19,Kansas,29,342,11.8,753,26,1095,37.8
2005,20,Washington,32,489,15.3,716,22.4,1205,37.7
2005,21,Pennsylvania,28,346,12.4,704,25.1,1050,37.5
2005,22,Florida,30,345,11.5,775,25.8,1120,37.3
2005,23,UCLA,28,334,11.9,707,25.3,1041,37.2
2005,24,Arizona,33,453,13.7,768,23.3,1221,37
2005,25,Alabama,31,322,10.4,824,26.6,1146,37
2005,26,Villanova,29,414,14.3,655,22.6,1069,36.9
2005,27,Milwaukee,29,390,13.4,676,23.3,1066,36.8
2005,28,George Washington,29,378,13,686,23.7,1064,36.7
2005,29,Old Dominion,33,399,12.1,810,24.5,1209,36.6
2005,30,Saint Mary's,33,409,12.4,793,24,1202,36.4
2005,31,LSU,29,333,11.5,722,24.9,1055,36.4
2005,32,Fairleigh Dickinson,32,393,12.3,765,23.9,1158,36.2
2005,33,Montana,30,310,10.3,775,25.8,1085,36.2
2005,34,Iowa,32,355,11.1,800,25,1155,36.1
2005,35,Michigan State,28,332,11.9,677,24.2,1009,36
2005,36,Stanford,30,368,12.3,711,23.7,1079,36
2005,37,Pacific,29,283,9.8,755,26,1038,35.8
2005,38,UCF,32,393,12.3,752,23.5,1145,35.8
2005,39,Kentucky,30,381,12.7,687,22.9,1068,35.6
2005,40,Eastern Kentucky,30,347,11.6,721,24,1068,35.6
2005,41,Oklahoma,31,395,12.7,696,22.5,1091,35.2
2005,42,Louisiana,30,424,14.1,631,21,1055,35.2
2005,43,Wisconsin,30,315,10.5,737,24.6,1052,35.1
2005,44,Iowa State,29,341,11.8,673,23.2,1014,35
2005,45,Winthrop,32,361,11.3,756,23.6,1117,34.9
2005,46,Texas Tech,30,341,11.4,705,23.5,1046,34.9
2005,47,UTEP,34,381,11.2,794,23.4,1175,34.6
2005,48,Oklahoma State,30,340,11.3,694,23.1,1034,34.5
2005,49,Illinois,33,362,11,772,23.4,1134,34.4
2005,50,Utah State,31,295,9.5,768,24.8,1063,34.3
2005,51,New Mexico,32,315,9.8,777,24.3,1092,34.1
2005,52,Utah,32,341,10.7,749,23.4,1090,34.1
2005,53,Minnesota,31,353,11.4,697,22.5,1050,33.9
2005,54,Northern Iowa,31,275,8.9,761,24.5,1036,33.4
2005,55,UAB,31,364,11.7,659,21.3,1023,33
2005,56,Southern Illinois,33,371,11.2,712,21.6,1083,32.8
2005,57,Ohio,31,338,10.9,679,21.9,1017,32.8
2005,58,Oakland,30,359,12,620,20.7,979,32.6
2005,59,NC State,32,355,11.1,686,21.4,1041,32.5
2005,60,Bucknell,31,290,9.4,695,22.4,985,31.8
2005,61,Creighton,33,326,9.9,710,21.5,1036,31.4
2005,62,SE Louisiana,32,346,10.8,652,20.4,998,31.2
2005,63,West Virginia,31,307,9.9,644,20.8,951,30.7
2005,64,Delaware State,32,325,10.2,556,17.4,881,27.5
2004,1,UConn,33,505,15.3,973,29.5,1478,44.8
2004,2,Texas,29,477,16.4,730,25.2,1207,41.6
2004,3,Maryland,29,457,15.8,740,25.5,1197,41.3
2004,4,Charlotte,29,428,14.8,759,26.2,1187,40.9
2004,5,Mississippi State,28,413,14.8,731,26.1,1144,40.9
2004,6,North Carolina,28,430,15.4,690,24.6,1120,40
2004,7,Arizona,30,414,13.8,782,26.1,1196,39.9
2004,8,Gonzaga,28,319,11.4,787,28.1,1106,39.5
2004,9,Kansas,29,366,12.6,773,26.7,1139,39.3
2004,10,Nevada,31,414,13.4,792,25.5,1206,38.9
2004,11,Syracuse,28,390,13.9,692,24.7,1082,38.6
2004,12,Memphis,28,377,13.5,704,25.1,1081,38.6
2004,13,East Tennessee State,32,394,12.3,837,26.2,1231,38.5
2004,14,Valparaiso,30,358,11.9,794,26.5,1152,38.4
2004,15,Western Michigan,30,431,14.4,710,23.7,1141,38
2004,16,Dayton,32,391,12.2,825,25.8,1216,38
2004,17,Louisville,29,338,11.7,762,26.3,1100,37.9
2004,18,VCU,30,370,12.3,762,25.4,1132,37.7
2004,19,UTSA,32,393,12.3,810,25.3,1203,37.6
2004,20,Wake Forest,28,393,14,658,23.5,1051,37.5
2004,21,Georgia Tech,32,364,11.4,835,26.1,1199,37.5
2004,22,Liberty,32,434,13.6,765,23.9,1199,37.5
2004,23,Murray State,33,407,12.3,827,25.1,1234,37.4
2004,24,Cincinnati,30,394,13.1,724,24.1,1118,37.3
2004,25,Seton Hall,29,339,11.7,740,25.5,1079,37.2
2004,26,Pittsburgh,33,425,12.9,785,23.8,1210,36.7
2004,27,Vermont,30,349,11.6,747,24.9,1096,36.5
2004,28,UCF,30,373,12.4,723,24.1,1096,36.5
2004,29,Boston College,32,410,12.8,759,23.7,1169,36.5
2004,30,South Carolina,33,419,12.7,780,23.6,1199,36.3
2004,31,Stanford,30,333,11.1,756,25.2,1089,36.3
2004,32,Duke,31,414,13.4,701,22.6,1115,36
2004,33,DePaul,30,362,12.1,713,23.8,1075,35.8
2004,34,Kentucky,29,338,11.7,699,24.1,1037,35.8
2004,35,Oklahoma State,29,338,11.7,697,24,1035,35.7
2004,36,Vanderbilt,30,343,11.4,726,24.2,1069,35.6
2004,37,Xavier,33,389,11.8,782,23.7,1171,35.5
2004,38,UIC,31,412,13.3,687,22.2,1099,35.5
2004,39,Florida,29,302,10.4,726,25,1028,35.4
2004,40,Southern Illinois,29,383,13.2,644,22.2,1027,35.4
2004,41,Washington,30,372,12.4,690,23,1062,35.4
2004,42,Alabama,29,328,11.3,696,24,1024,35.3
2004,43,Illinois,29,349,12,673,23.2,1022,35.2
2004,44,Richmond,33,390,11.8,771,23.4,1161,35.2
2004,45,UAB,29,358,12.3,658,22.7,1016,35
2004,46,Manhattan,29,353,12.2,658,22.7,1011,34.9
2004,47,Utah,32,346,10.8,768,24,1114,34.8
2004,48,UTEP,31,319,10.3,758,24.5,1077,34.7
2004,49,Northern Iowa,30,265,8.8,775,25.8,1040,34.7
2004,50,Alabama State,30,351,11.7,683,22.8,1034,34.5
2004,51,Louisiana,28,330,11.8,626,22.4,956,34.1
2004,52,Texas Tech,32,362,11.3,726,22.7,1088,34
2004,53,Florida A&M,30,343,11.4,676,22.5,1019,34
2004,54,BYU,29,301,10.4,682,23.5,983,33.9
2004,55,NC State,29,291,10,687,23.7,978,33.7
2004,56,Pacific,31,288,9.3,757,24.4,1045,33.7
2004,57,Providence,28,327,11.7,613,21.9,940,33.6
2004,58,Monmouth,32,300,9.4,768,24,1068,33.4
2004,59,Wisconsin,29,329,11.3,626,21.6,955,32.9
2004,60,Saint Joseph's,28,271,9.7,651,23.3,922,32.9
2004,61,Princeton,27,232,8.6,601,22.3,833,30.9
2004,62,Eastern Washington,29,267,9.2,624,21.5,891,30.7
2004,63,Michigan State,29,264,9.1,620,21.4,884,30.5
2004,64,Air Force,28,172,6.1,430,15.4,602,21.5
2003,1,Arizona,28,425,15.2,774,27.6,1199,42.8
2003,2,UConn,30,443,14.8,837,27.9,1280,42.7
2003,3,Colorado,31,449,14.5,867,28,1316,42.5
2003,4,Texas,28,453,16.2,732,26.1,1185,42.3
2003,5,Wake Forest,29,428,14.8,781,26.9,1209,41.7
2003,,Kansas,32,453,14.2,881,27.5,1334,41.7
2003,7,Syracuse,29,415,14.3,780,26.9,1195,41.2
2003,8,Maryland,28,385,13.8,749,26.8,1134,40.5
2003,9,Troy,31,474,15.3,778,25.1,1252,40.4
2003,10,Memphis,29,408,14.1,753,26,1161,40
2003,11,Missouri,30,410,13.7,778,25.9,1188,39.6
2003,12,Xavier,31,435,14,792,25.5,1227,39.6
2003,13,Vermont,32,417,13,845,26.4,1262,39.4
2003,14,Stanford,31,426,13.7,779,25.1,1205,38.9
2003,15,East Tennessee State,30,424,14.1,739,24.6,1163,38.8
2003,16,Louisville,30,396,13.2,753,25.1,1149,38.3
2003,17,Notre Dame,31,353,11.4,833,26.9,1186,38.3
2003,18,San Diego,29,337,11.6,771,26.6,1108,38.2
2003,19,Alabama,28,380,13.6,670,23.9,1050,37.5
2003,20,Mississippi State,29,366,12.6,719,24.8,1085,37.4
2003,21,Oklahoma,29,357,12.3,725,25,1082,37.3
2003,22,Gonzaga,31,370,11.9,785,25.3,1155,37.3
2003,23,South Carolina State,30,389,13,728,24.3,1117,37.2
2003,24,Marquette,28,367,13.1,674,24.1,1041,37.2
2003,25,Kentucky,31,405,13.1,746,24.1,1151,37.1
2003,26,Indiana,33,369,11.2,854,25.9,1223,37.1
2003,27,Sam Houston State,29,326,11.2,748,25.8,1074,37
2003,28,Tulsa,31,346,11.2,800,25.8,1146,37
2003,29,Arizona State,30,407,13.6,702,23.4,1109,37
2003,30,Duke,29,403,13.9,667,23,1070,36.9
2003,31,Oklahoma State,30,376,12.5,727,24.2,1103,36.8
2003,32,Pittsburgh,30,339,11.3,761,25.4,1100,36.7
2003,33,Dayton,29,391,13.5,672,23.2,1063,36.7
2003,34,Holy Cross,30,363,12.1,734,24.5,1097,36.6
2003,35,Western Kentucky,32,394,12.3,757,23.7,1151,36
2003,36,Oregon,32,364,11.4,784,24.5,1148,35.9
2003,37,UNC Asheville,30,366,12.2,706,23.5,1072,35.7
2003,38,Colorado State,32,363,11.3,777,24.3,1140,35.6
2003,39,California,29,326,11.2,707,24.4,1033,35.6
2003,40,Cincinnati,28,340,12.1,655,23.4,995,35.5
2003,41,Saint Joseph's,29,324,11.2,700,24.1,1024,35.3
2003,42,BYU,31,338,10.9,755,24.4,1093,35.3
2003,43,Austin Peay,30,331,11,724,24.1,1055,35.2
2003,44,Auburn,31,377,12.2,712,23,1089,35.1
2003,45,LSU,31,329,10.6,760,24.5,1089,35.1
2003,46,Florida,31,335,10.8,752,24.3,1087,35.1
2003,47,Utah State,32,401,12.5,721,22.5,1122,35.1
2003,48,Illinois,29,280,9.7,735,25.3,1015,35
2003,49,Michigan State,31,331,10.7,752,24.3,1083,34.9
2003,50,Manhattan,29,328,11.3,676,23.3,1004,34.6
2003,51,Milwaukee,31,356,11.5,713,23,1069,34.5
2003,52,Wagner,31,372,12,693,22.4,1065,34.4
2003,53,Creighton,33,359,10.9,765,23.2,1124,34.1
2003,54,Central Michigan,30,322,10.7,696,23.2,1018,33.9
2003,55,Purdue,28,291,10.4,657,23.5,948,33.9
2003,56,Pennsylvania,27,252,9.3,653,24.2,905,33.5
2003,57,Utah,31,312,10.1,723,23.3,1035,33.4
2003,58,Weber State,31,323,10.4,711,22.9,1034,33.4
2003,59,Southern Illinois,30,325,10.8,674,22.5,999,33.3
2003,60,UNC Wilmington,30,299,10,694,23.1,993,33.1
2003,61,IUPUI,33,389,11.8,698,21.2,1087,32.9
2003,62,Wisconsin,29,299,10.3,654,22.6,953,32.9
2003,63,NC State,29,280,9.7,636,21.9,916,31.6
2003,64,Butler,30,237,7.9,611,20.4,848,28.3
2002,1,Kansas,32,480,15,925,28.9,1405,43.9
2002,2,Stanford,28,415,14.8,759,27.1,1174,41.9
2002,3,Maryland,30,406,13.5,842,28.1,1248,41.6
2002,4,Gonzaga,32,403,12.6,925,28.9,1328,41.5
2002,5,UConn,30,419,14,821,27.4,1240,41.3
2002,6,Notre Dame,31,403,13,859,27.7,1262,40.7
2002,7,Kentucky,29,451,15.6,719,24.8,1170,40.3
2002,8,Wyoming,29,374,12.9,792,27.3,1166,40.2
2002,9,Oklahoma State,31,468,15.1,773,24.9,1241,40
2002,10,Oklahoma,31,471,15.2,770,24.8,1241,40
2002,11,Murray State,31,487,15.7,752,24.3,1239,40
2002,12,Texas,31,479,15.5,760,24.5,1239,40
2002,13,Cincinnati,33,429,13,872,26.4,1301,39.4
2002,14,Florida Atlantic,30,492,16.4,690,23,1182,39.4
2002,15,Central Connecticut,31,408,13.2,811,26.2,1219,39.3
2002,16,Mississippi State,33,437,13.2,860,26.1,1297,39.3
2002,17,Alabama,33,483,14.6,812,24.6,1295,39.2
2002,18,Southern Illinois,33,438,13.3,849,25.7,1287,39
2002,19,Florida,30,413,13.8,751,25,1164,38.8
2002,20,Wake Forest,32,418,13.1,821,25.7,1239,38.7
2002,21,Pittsburgh,32,419,13.1,820,25.6,1239,38.7
2002,22,Western Kentucky,31,393,12.7,802,25.9,1195,38.5
2002,23,Missouri,32,474,14.8,759,23.7,1233,38.5
2002,24,USC,31,441,14.2,753,24.3,1194,38.5
2002,25,Davidson,30,353,11.8,801,26.7,1154,38.5
2002,26,Texas Tech,31,396,12.8,792,25.5,1188,38.3
2002,27,Winthrop,30,392,13.1,757,25.2,1149,38.3
2002,28,Georgia,30,434,14.5,711,23.7,1145,38.2
2002,29,Charlotte,29,364,12.6,739,25.5,1103,38
2002,30,Pepperdine,30,394,13.1,744,24.8,1138,37.9
2002,31,McNeese,29,391,13.5,708,24.4,1099,37.9
2002,32,Siena,34,381,11.2,906,26.6,1287,37.9
2002,33,St. John's,31,487,15.7,686,22.1,1173,37.8
2002,34,Valparaiso,32,437,13.7,771,24.1,1208,37.8
2002,35,Arizona,31,391,12.6,778,25.1,1169,37.7
2002,36,Hampton,32,443,13.8,763,23.8,1206,37.7
2002,37,Michigan State,30,365,12.2,765,25.5,1130,37.7
2002,38,Kent State,32,428,13.4,776,24.3,1204,37.6
2002,39,Boston College,31,440,14.2,724,23.4,1164,37.5
2002,39,Boston University,31,376,12.1,786,25.4,1162,37.5
2002,41,Duke,32,390,12.2,804,25.1,1194,37.3
2002,42,San Diego State,32,388,12.1,805,25.2,1193,37.3
2002,43,Oregon,31,345,11.1,803,25.9,1148,37
2002,44,Xavier,30,367,12.2,743,24.8,1110,37
2002,45,Miami,31,371,12,764,24.6,1135,36.6
2002,46,Illinois,32,362,11.3,800,25,1162,36.3
2002,47,UCLA,30,346,11.5,737,24.6,1083,36.1
2002,48,Indiana,31,351,11.3,761,24.5,1112,35.9
2002,49,Holy Cross,32,405,12.7,741,23.2,1146,35.8
2002,50,Tulsa,32,343,10.7,799,25,1142,35.7
2002,51,Marquette,32,406,12.7,736,23,1142,35.7
2002,52,Creighton,30,348,11.6,712,23.7,1060,35.3
2002,53,UC Santa Barbara,30,291,9.7,760,25.3,1051,35
2002,54,UIC,33,410,12.4,734,22.2,1144,34.7
2002,55,UNC Wilmington,31,349,11.3,713,23,1062,34.3
2002,56,California,30,340,11.3,677,22.6,1017,33.9
2002,57,Montana,30,295,9.8,721,24,1016,33.9
2002,58,Hawai'i,32,329,10.3,739,23.1,1068,33.4
2002,59,Ole Miss,30,318,10.6,680,22.7,998,33.3
2002,60,NC State,32,333,10.4,731,22.8,1064,33.3
2002,61,Ohio State,30,328,10.9,662,22.1,990,33
2002,62,Wisconsin,30,309,10.3,662,22.1,971,32.4
2002,63,Pennsylvania,31,254,8.2,749,24.2,1003,32.4
2002,64,Utah,29,254,8.8,635,21.9,889,30.7